10
........o.
ooooo.....
o.........
o.oo......
o.o.o.....
.....ooooo
..o...oooo
..ooo.....
.oo.oo....
..........